let lvl1 = `***********.*
*S.....**.*.T
*****.....*.*
*****.***.*.*
*****.*****.*
*****.*****.*
*****.......*
*****.*******
*.........***
*.******...**
*....********`;

let lvl2 = `**********************
*..S.................*
********************.*
*....................*
*.********************
*...................T*`

let lvl3 = `********
****S***
****.***
****.***
****.***
*......*
*.****.*
*..***.*
*..***.*
**.*****
*T.*****
********`

let lvl4 = `**********
****S....*
*....***.*
*.**.***.*
*.**.***.*
*...*....*
******.***
*..***....
*..***.*.*
**....**.*
*T.**....*
**********`;